8
8
1 1 1 1 2 2 2 2
6 0 0 1 0 0 0 2
1 0 0 4 0 2 0 2
1 5 4 5 0 0 0 2
2 0 0 0 0 0 0 1
2 0 0 0 0 1 0 1
2 0 0 0 0 0 0 1
1 1 1 1 1 1 1 1